########
#......#
# ## #.#
#.#P.#.#
#G . #G#
########
